30 100
TACTGTCAATTGTGTTGGCCGGACAAAAAT|CTTGTGTTGGCCGGACAAAAATTACGTTCC
AATATCGGGGGACTCGCAATAGGTTACAAA|CGGCTAATGGCCTGTAACGGCATGATTAAC
CTTGTATTAACCTAACGATTGTAATTAATT|TTCGGAATTTTGTGTTGGCCGGACAAAAAT
CATTGTGTTGGCCGGACAAAAATTACGTTC|ATTGTTTTGTGGCTTGTATTAACCTAACGA
CTATTGTAGTGGGGTATGTTGTGTTGGCCG|ACGTGTACCGCATGTGGCGACTGCGAATGA
CCAAACAATATCGGGGGACTCGCAATAGGT|TACTATCGGCTAATGGCCTGTAACGGCATG
GGTTGTGTTGGCCGGACAAAAATTACGTTC|GCACTACCCAGGTTTACACTAGCTGGCGTA
TATAACACTCATTATCGTCAACCAAGCTTG|GGACAAAAATTACGTTCCAGCTACGCTGCC
AATGAGCTAGTACGTTCTTTGCTACTGAGC|GCTTTTCGCGGATTCTAGCGTCTGCCTTCC
ACTATCGGCTAATGGCCTGTAACGGCATGA|TCGTCAACCAAGCTTGGCCGGCGGGTTGTG
CGTTGTGTTGGCCGGACAAAAATTACGTTT|GGACAAAAATTACGTTCCAACAAAAATTAC
AATAGGTTACAAAAGCTCATCAAACACAGC|CGGCATGATTAACATCAAGGACTAGGCTTT
CCAAGCGTCTTTCCGCGTAAATGACTAGGA|GCTACTGTCAATTGTGTTGGCCGGACAAAA
CCCCGCAGCAATTGTGTTGGCCGGTTGTGT|GGACTCGCAATAGGTTACAAAAGCTCATCA
AAACACAGCCTGTCTAACTATTGCCTTCAA|CTAGGCTTTTAGCCAAGCGTCTTTCCGCGT
AATTGTGTTGGCCGGTTGTGTTGGCCGGAC|ATAGGTTACAAAAGCTCATCAAACACAGCC
GACTGTAGGAGATTTGTGGATACGTGTACC|TCCCCTGTGTTTTACGAACGACTAAGGCTT
GGCTTGTACTATCGGCTAATGGCCTGTAAC|CTCATTATCGTCAACCAAGCTTGGCCGGCG
CCGGACAAAAATTACGTTCCATGCAGTCAT|TGGCCGGACAAAAATTACGTTTTGTGTTGG
CCACCATTCCACTCTGATATGGTTTGTATA|TGTTGGCCGGACAAAAATTACGTTCCAAAC
GCATTGTTTGGTGTGGTCCAAGCGTTTGCC|GCGAGGGAGACTGTAGGAGATTTGTGGATA
TTGCCTATTGTAGTGGGGTATGTTGTGTTG|GGATACGTGTACCGCATGTGGCGACTGCGA
GGACAAAAATTACGTTCCAGCTACGCTGCC|TTGTATTAACCTAACGATTGTAATTAATTC
TTCGAGCAAAGGGCGGGAATCCCCTGTGTT|CGGACAAAAATTACGTTCCAAAGTGGACGC
TTTGCTACTGAGCTAGGGATAAGTTGTTCT|GCGTCTGCCTTCCCCACAGACTTGAGCCGT
AAAAATTACGTTCCATAAGGAACATTGTGT|CGTTCCAGAGTTTTTTTCGATAATTGTTTT
GTGTTTTACGAACGACTAAGGCTTAATAGC|GACGCTGTGCCGGTAGTCCGCTCGTGCCAT
GGGTATGTTGTGTTGGCCGGACAAAAATTA|ATGTGGCGACTGCGAATGAGCTAGTACGTT
CATCAAACACAGCCTGTCTAACTATTGCCT|AGGACTAGGCTTTTAGCCAAGCGTCTTTCC
ACGTTGTGTTGGCCGGACAAAAATTACGTT|CGGACAAAAATTACGTTCCAACAAAAATTA
ATTACGTTTTGTGTTGGCCGGACAAAAATT|AAAAATTACGTTCCATTAGTTGAGAGACGA
TTGGCCGGACAAAAATTACGTTTTGTGTTG|AATTACGTTCCAACAAAAATTACGTTCCAT
TCGGCTAATGGCCTGTAACGGCATGATTAA|CAACCAAGCTTGGCCGGCGGGTTGTGTTGG
TGTTGTTGTGTTGGCCGGACAAAAATTACG|GAGATTTGTGTTGGCCGGACAAAAATTACG
TGTTGGCCGGTTGTGTTGGCCGGACAAAAA|TTACAAAAGCTCATCAAACACAGCCTGTCT
TGTGTTGGCCGGACAAAAATTACGTTCCAG|TGTGTTGGCCGGACAAAAATTACGTTGTGT
CGTTCCACATTCGGAATTTTGTGTTGGCCG|CTTTGCTACTGAGCTAGGGATAAGTTGTTC
GCTGGCGTATTTTCTTGTGTTGGCCGGACA|TGGTGTGGTCCAAGCGTTTGCCTATTGTAG
TTGTATATTAGACATTCCCCGCAGCAATTG|TCCAAACAATATCGGGGGACTCGCAATAGG
CAAAAATTACGTTTTGTGTTGGCCGGACAA|CCAACAAAAATTACGTTCCATTAGTTGAGA
ATTACGTTCCAGCTACTGTCAATTGTGTTG|GCTGGCGTATTTTCTTGTGTTGGCCGGACA
TTAGCCAAGCGTCTTTCCGCGTAAATGACT|TCCAGCTACTGTCAATTGTGTTGGCCGGAC
TTGTGTTGTTGTGTTGGCCGGACAAAAATT|GATGAGATTTGTGTTGGCCGGACAAAAATT
TTGTGTTGGCCGGACAAAAATTACGTTCCA|CGTTTGCCTATTGTAGTGGGGTATGTTGTG
ATTTGTGTTGGCCGGACAAAAATTACGTTG|ATTGTGTTGGCCGGTTGTGTTGGCCGGACA
TGTGTTGGCCGGACAAAAATTACGTTCCAC|ACTGCGAATGAGCTAGTACGTTCTTTGCTA
TGGCCGGTTGTGTTGGCCGGACAAAAATTA|CAAAAGCTCATCAAACACAGCCTGTCTAAC
AACAAAAATTACGTTCCATTAGTTGAGAGA|CTTCAAAGCCCAAAGCATGCTATGCTTCCG
GTTGTTCTTAACCAAAGGTAAATTCTTTCG|TGAGCCGTTGTCCCTATTGTGTTGGCCGGA
