AAAAATTACGTTCCATAAGGAACATTGTG|CGTTCCAGAGTTTTTTTCGATAATTGTTT -> AAAATTACGTTCCATAAGGAACATTGTGT|GTTCCAGAGTTTTTTTCGATAATTGTTTT
AAACACAGCCTGTCTAACTATTGCCTTCA|CTAGGCTTTTAGCCAAGCGTCTTTCCGCG -> AACACAGCCTGTCTAACTATTGCCTTCAA|TAGGCTTTTAGCCAAGCGTCTTTCCGCGT
AACAAAAATTACGTTCCATTAGTTGAGAG|CTTCAAAGCCCAAAGCATGCTATGCTTCC -> ACAAAAATTACGTTCCATTAGTTGAGAGA|TTCAAAGCCCAAAGCATGCTATGCTTCCG
AATAGGTTACAAAAGCTCATCAAACACAG|CGGCATGATTAACATCAAGGACTAGGCTT -> ATAGGTTACAAAAGCTCATCAAACACAGC|GGCATGATTAACATCAAGGACTAGGCTTT
AATATCGGGGGACTCGCAATAGGTTACAA|CGGCTAATGGCCTGTAACGGCATGATTAA -> ATATCGGGGGACTCGCAATAGGTTACAAA|GGCTAATGGCCTGTAACGGCATGATTAAC
AATGAGCTAGTACGTTCTTTGCTACTGAG|GCTTTTCGCGGATTCTAGCGTCTGCCTTC -> ATGAGCTAGTACGTTCTTTGCTACTGAGC|CTTTTCGCGGATTCTAGCGTCTGCCTTCC
AATTGTGTTGGCCGGTTGTGTTGGCCGGA|ATAGGTTACAAAAGCTCATCAAACACAGC -> ATTGTGTTGGCCGGTTGTGTTGGCCGGAC|TAGGTTACAAAAGCTCATCAAACACAGCC
ACGTTGTGTTGGCCGGACAAAAATTACGT|CGGACAAAAATTACGTTCCAACAAAAATT -> CGTTGTGTTGGCCGGACAAAAATTACGTT|GGACAAAAATTACGTTCCAACAAAAATTA
ACTATCGGCTAATGGCCTGTAACGGCATG|TCGTCAACCAAGCTTGGCCGGCGGGTTGT -> CTATCGGCTAATGGCCTGTAACGGCATGA|CGTCAACCAAGCTTGGCCGGCGGGTTGTG
ATTACGTTCCAGCTACTGTCAATTGTGTT|GCTGGCGTATTTTCTTGTGTTGGCCGGAC -> TTACGTTCCAGCTACTGTCAATTGTGTTG|CTGGCGTATTTTCTTGTGTTGGCCGGACA
ATTACGTTTTGTGTTGGCCGGACAAAAAT|AAAAATTACGTTCCATTAGTTGAGAGACG -> TTACGTTTTGTGTTGGCCGGACAAAAATT|AAAATTACGTTCCATTAGTTGAGAGACGA
ATTTGTGTTGGCCGGACAAAAATTACGTT|ATTGTGTTGGCCGGTTGTGTTGGCCGGAC -> TTTGTGTTGGCCGGACAAAAATTACGTTG|TTGTGTTGGCCGGTTGTGTTGGCCGGACA
CAAAAATTACGTTTTGTGTTGGCCGGACA|CCAACAAAAATTACGTTCCATTAGTTGAG -> AAAAATTACGTTTTGTGTTGGCCGGACAA|CAACAAAAATTACGTTCCATTAGTTGAGA
CATCAAACACAGCCTGTCTAACTATTGCC|AGGACTAGGCTTTTAGCCAAGCGTCTTTC -> ATCAAACACAGCCTGTCTAACTATTGCCT|GGACTAGGCTTTTAGCCAAGCGTCTTTCC
CATTGTGTTGGCCGGACAAAAATTACGTT|ATTGTTTTGTGGCTTGTATTAACCTAACG -> ATTGTGTTGGCCGGACAAAAATTACGTTC|TTGTTTTGTGGCTTGTATTAACCTAACGA
CCAAACAATATCGGGGGACTCGCAATAGG|TACTATCGGCTAATGGCCTGTAACGGCAT -> CAAACAATATCGGGGGACTCGCAATAGGT|ACTATCGGCTAATGGCCTGTAACGGCATG
CCAAGCGTCTTTCCGCGTAAATGACTAGG|GCTACTGTCAATTGTGTTGGCCGGACAAA -> CAAGCGTCTTTCCGCGTAAATGACTAGGA|CTACTGTCAATTGTGTTGGCCGGACAAAA
CCACCATTCCACTCTGATATGGTTTGTAT|TGTTGGCCGGACAAAAATTACGTTCCAAA -> CACCATTCCACTCTGATATGGTTTGTATA|GTTGGCCGGACAAAAATTACGTTCCAAAC
CCCCGCAGCAATTGTGTTGGCCGGTTGTG|GGACTCGCAATAGGTTACAAAAGCTCATC -> CCCGCAGCAATTGTGTTGGCCGGTTGTGT|GACTCGCAATAGGTTACAAAAGCTCATCA
CCGGACAAAAATTACGTTCCATGCAGTCA|TGGCCGGACAAAAATTACGTTTTGTGTTG -> CGGACAAAAATTACGTTCCATGCAGTCAT|GGCCGGACAAAAATTACGTTTTGTGTTGG
CGTTCCACATTCGGAATTTTGTGTTGGCC|CTTTGCTACTGAGCTAGGGATAAGTTGTT -> GTTCCACATTCGGAATTTTGTGTTGGCCG|TTTGCTACTGAGCTAGGGATAAGTTGTTC
CGTTGTGTTGGCCGGACAAAAATTACGTT|GGACAAAAATTACGTTCCAACAAAAATTA -> GTTGTGTTGGCCGGACAAAAATTACGTTT|GACAAAAATTACGTTCCAACAAAAATTAC
CTATTGTAGTGGGGTATGTTGTGTTGGCC|ACGTGTACCGCATGTGGCGACTGCGAATG -> TATTGTAGTGGGGTATGTTGTGTTGGCCG|CGTGTACCGCATGTGGCGACTGCGAATGA
CTTGTATTAACCTAACGATTGTAATTAAT|TTCGGAATTTTGTGTTGGCCGGACAAAAA -> TTGTATTAACCTAACGATTGTAATTAATT|TCGGAATTTTGTGTTGGCCGGACAAAAAT
GACTGTAGGAGATTTGTGGATACGTGTAC|TCCCCTGTGTTTTACGAACGACTAAGGCT -> ACTGTAGGAGATTTGTGGATACGTGTACC|CCCCTGTGTTTTACGAACGACTAAGGCTT
GCATTGTTTGGTGTGGTCCAAGCGTTTGC|GCGAGGGAGACTGTAGGAGATTTGTGGAT -> CATTGTTTGGTGTGGTCCAAGCGTTTGCC|CGAGGGAGACTGTAGGAGATTTGTGGATA
GCTGGCGTATTTTCTTGTGTTGGCCGGAC|TGGTGTGGTCCAAGCGTTTGCCTATTGTA -> CTGGCGTATTTTCTTGTGTTGGCCGGACA|GGTGTGGTCCAAGCGTTTGCCTATTGTAG
GGACAAAAATTACGTTCCAGCTACGCTGC|TTGTATTAACCTAACGATTGTAATTAATT -> GACAAAAATTACGTTCCAGCTACGCTGCC|TGTATTAACCTAACGATTGTAATTAATTC
GGCTTGTACTATCGGCTAATGGCCTGTAA|CTCATTATCGTCAACCAAGCTTGGCCGGC -> GCTTGTACTATCGGCTAATGGCCTGTAAC|TCATTATCGTCAACCAAGCTTGGCCGGCG
GGGTATGTTGTGTTGGCCGGACAAAAATT|ATGTGGCGACTGCGAATGAGCTAGTACGT -> GGTATGTTGTGTTGGCCGGACAAAAATTA|TGTGGCGACTGCGAATGAGCTAGTACGTT
GGTTGTGTTGGCCGGACAAAAATTACGTT|GCACTACCCAGGTTTACACTAGCTGGCGT -> GTTGTGTTGGCCGGACAAAAATTACGTTC|CACTACCCAGGTTTACACTAGCTGGCGTA
GTGTTTTACGAACGACTAAGGCTTAATAG|GACGCTGTGCCGGTAGTCCGCTCGTGCCA -> TGTTTTACGAACGACTAAGGCTTAATAGC|ACGCTGTGCCGGTAGTCCGCTCGTGCCAT
GTTGTTCTTAACCAAAGGTAAATTCTTTC|TGAGCCGTTGTCCCTATTGTGTTGGCCGG -> TTGTTCTTAACCAAAGGTAAATTCTTTCG|GAGCCGTTGTCCCTATTGTGTTGGCCGGA
TACTGTCAATTGTGTTGGCCGGACAAAAA|CTTGTGTTGGCCGGACAAAAATTACGTTC -> ACTGTCAATTGTGTTGGCCGGACAAAAAT|TTGTGTTGGCCGGACAAAAATTACGTTCC
TATAACACTCATTATCGTCAACCAAGCTT|GGACAAAAATTACGTTCCAGCTACGCTGC -> ATAACACTCATTATCGTCAACCAAGCTTG|GACAAAAATTACGTTCCAGCTACGCTGCC
TCGGCTAATGGCCTGTAACGGCATGATTA|CAACCAAGCTTGGCCGGCGGGTTGTGTTG -> CGGCTAATGGCCTGTAACGGCATGATTAA|AACCAAGCTTGGCCGGCGGGTTGTGTTGG
TGGCCGGTTGTGTTGGCCGGACAAAAATT|CAAAAGCTCATCAAACACAGCCTGTCTAA -> GGCCGGTTGTGTTGGCCGGACAAAAATTA|AAAAGCTCATCAAACACAGCCTGTCTAAC
TGTGTTGGCCGGACAAAAATTACGTTCCA|ACTGCGAATGAGCTAGTACGTTCTTTGCT -> GTGTTGGCCGGACAAAAATTACGTTCCAC|CTGCGAATGAGCTAGTACGTTCTTTGCTA
TGTGTTGGCCGGACAAAAATTACGTTCCA|TGTGTTGGCCGGACAAAAATTACGTTGTG -> GTGTTGGCCGGACAAAAATTACGTTCCAG|GTGTTGGCCGGACAAAAATTACGTTGTGT
TGTTGGCCGGTTGTGTTGGCCGGACAAAA|TTACAAAAGCTCATCAAACACAGCCTGTC -> GTTGGCCGGTTGTGTTGGCCGGACAAAAA|TACAAAAGCTCATCAAACACAGCCTGTCT
TGTTGTTGTGTTGGCCGGACAAAAATTAC|GAGATTTGTGTTGGCCGGACAAAAATTAC -> GTTGTTGTGTTGGCCGGACAAAAATTACG|AGATTTGTGTTGGCCGGACAAAAATTACG
TTAGCCAAGCGTCTTTCCGCGTAAATGAC|TCCAGCTACTGTCAATTGTGTTGGCCGGA -> TAGCCAAGCGTCTTTCCGCGTAAATGACT|CCAGCTACTGTCAATTGTGTTGGCCGGAC
TTCGAGCAAAGGGCGGGAATCCCCTGTGT|CGGACAAAAATTACGTTCCAAAGTGGACG -> TCGAGCAAAGGGCGGGAATCCCCTGTGTT|GGACAAAAATTACGTTCCAAAGTGGACGC
TTGCCTATTGTAGTGGGGTATGTTGTGTT|GGATACGTGTACCGCATGTGGCGACTGCG -> TGCCTATTGTAGTGGGGTATGTTGTGTTG|GATACGTGTACCGCATGTGGCGACTGCGA
TTGGCCGGACAAAAATTACGTTTTGTGTT|AATTACGTTCCAACAAAAATTACGTTCCA -> TGGCCGGACAAAAATTACGTTTTGTGTTG|ATTACGTTCCAACAAAAATTACGTTCCAT
TTGTATATTAGACATTCCCCGCAGCAATT|TCCAAACAATATCGGGGGACTCGCAATAG -> TGTATATTAGACATTCCCCGCAGCAATTG|CCAAACAATATCGGGGGACTCGCAATAGG
TTGTGTTGGCCGGACAAAAATTACGTTCC|CGTTTGCCTATTGTAGTGGGGTATGTTGT -> TGTGTTGGCCGGACAAAAATTACGTTCCA|GTTTGCCTATTGTAGTGGGGTATGTTGTG
TTGTGTTGTTGTGTTGGCCGGACAAAAAT|GATGAGATTTGTGTTGGCCGGACAAAAAT -> TGTGTTGTTGTGTTGGCCGGACAAAAATT|ATGAGATTTGTGTTGGCCGGACAAAAATT
TTTGCTACTGAGCTAGGGATAAGTTGTTC|GCGTCTGCCTTCCCCACAGACTTGAGCCG -> TTGCTACTGAGCTAGGGATAAGTTGTTCT|CGTCTGCCTTCCCCACAGACTTGAGCCGT
AAAAATTACGTTCCATAAGGAACATTGTGTCGTTCCAGAGTTTTTTTCGATAATTGTTTT
